..................
.....S............
...##.#####..###..
###...###..##..#..
#.........##...###
#####.#....X.#####
................##
###.............##
####..............