.#..#..............#......
.#S...#......##..###..###.
...##.#..#...##..###..#.#.
.........#.........#..###.
.##..##..##.....#.........
.#....#.....#..##..#..#...
.#..#.......#.........#..#
...........#.##.#...#.#...
.#.#...#...#....X.....#...
...#####........#.........